11 11 2
@@@@@@@@@@@
K........@@
@..@@@@@..@
@.@@@@@@@.@
@.@@@@@@@.@
@.@@@@@@@.@
@.@@@@@@@.@
@.@@@@@@@.@
@..@@@@@..@
@@.......@@
@@@@@@@@|@@
@@@@@@@@@@@
K........@@
@.@@@@@@..@
@.@@@@@@@.@
@.@@@@@@..@
@........@@
@.@@@@@@..@
@.@@@@@@@.@
@.@@@@@@..@
@........@@
@@@@@@@@C@@